NO ./textures/blue.xpm
SO ./textures/green.xpm
WE ./textures/yellow.xpm
EA ./textures/red.xpm

C 200, 200, 200
F 55, 55, 55

11111111111111111111111111111111111111111111111111111111111111111111111111111111111111111111111111111111111111111111111111111111111111111111111111111111111111111111111
1E000000000000000000000000000000000000000000000000000000000000000000000000000000000000000000000000000000000000000000000000000000000000000000000000000000000000000000001
11111111111111111111111111111111111111111111111111111111111111111111111111111111111111111111111111111111111111111111111111111111111111111111111111111111111111111111111