NO ./textures/cobblestone.xpm
SO ./textures/dirt.xpm
WE ./textures/grass_side.xpm
EA ./textures/grass_top.xpm

F 121, 196, 242
C 173, 104, 161

11111
10001
10N01
10001
11111