NO ./textures/cobblestone.xpm
SO ./textures/dirt.xpm
WE ./textures/grass_side.xpm
EA ./textures/grass_top.xpm

F 255, 255, 255
C 50, 50, 50

11111
10001
10N01
10001
11111